; 1

YEEEEEEEEE
ETTMEEMMME
EEMBEEEBME
HEEEEVEEME
BEETTTEVEE
TEEBTTEEEE
TEEEEEEEBE
EVTTEEEMME
EEBEEBTTEE
EEEEEEEEEH

; 2

MMTEEMMEEY
TTBEEEEEEE
MTTEEHEETT
MEBEEEMEEB
METVEEMVEE
EEBEEEMEEE
EHEEEEEETE
EEETEEEEEB
ETBEEHEETT
EEETEEEETT

; 3

MEVEEEEEBM
BEETTTTEEE
EHEEBBEEHE
EEETTTTEEE
EEEEEEEVEV
BTEETTEETE
ETEETTEETB
BTEETTEETE
ETEETTEETB
VEEEEYEEEE

; 4

MBEEEEEEBT
BMEEVEEETB
EEMEEEETEE
EEEMEETEEV
EEHEEEEEEE
EEEEEEEEEE
VEETEEMEEE
EETEEEEMEE
BTEEEEEEMB
TBEEEEEYBM

; 5

EEEEEVEEEH
EETTTEMMEE
EEBTTEMMBE
EEEEEBEEEE
YEETMEMEEV
EEEEEEBTEE
EEHEEVEEEE
EMTTMMTTME
ETMBMBMTTE
EEEEEEHEEE

; 6

BEEEEEEEEH
MMMMMEEETT
HEEEEEEEEB
TTEEEMMMMM
BEEEEEEHEE
MMMMMEEETT
EEEHEEEEEB
TTEEEMMMMM
BEEEEEEEEB
TTTEEYETTT

; 7

MTEEYEEEMM
MTEEEEEEEB
MTEEEEEMTM
BTEEMMVBMT
EEEEHEEEEE
EEEETTEEEE
VEEEBEEEEV
EMTETTEETE
EBMEEEEETB
EEEHEEEBTT

; 8

BTEEETEBET
EHETEHETEE
ETBEETBEET
EEETEHETEB
ETEBETEHET
EHETEEETEE
ETEEBTEHET
EEETEHETEE
ETEEETEBET
YEETEEETEE

; 9

TMTEMTMEMT
MBMEEBTEBM
TETEMTMEEE
EEEHEEEETM
MTMEEEEVEY
TBEEEEEETM
MTMEEEEHEE
EEEVTMTEEE
TBTEMBEEET
MTMETMTETM

; 10

EYMEMBMEMB
EEMEMEMEEE
EHEEEEEEEE
ETTETTETTE
EEVEEEEHEV
MMEMMBMMEM
EHEEEEEEEE
TETETTETET
TETETTETVT
TETBTTETBT